2 2 2 2 2 2 2 2 2 2 2 2 2 2 2
2 2 0 0 2 2 2 2 2 2 2 0 0 2 2
3 3 0 0 3 3 3 1 3 3 3 0 0 3 3
3 3 3 3 3 3 3 1 3 3 3 3 3 3 3
4 1 4 4 4 4 4 4 4 4 4 4 4 1 4
4 4 1 0 0 0 0 0 0 0 0 0 1 4 4
5 5 5 5 5 5 0 0 0 5 5 5 5 5 5
5 5 5 5 5 5 5 5 5 5 5 5 5 5 5